!Level_1
!
!
!
!
!
!
32222222222221
6            4
6            4
6            4
6     $      4
6            4
6            4
98888888888887